NO ./textures/d_wall1.XPM

SO ./textures/d_wall2.XPM

WE ./textures/d_wall3.XPM

EA ./textures/d_wall4.XPM

C 40,50,60
F 60,50,40

111
1011
10011111111
10000000001111111111111111111111111111111
100011110000000000000000000000000000001
10001  1001111111111111111111111101111111
10000111111                     101
100001111              1   1    101
1000000011111111111     1 1     101
1E00000000000000001      1      101
1111111101101100001      1  11  101
      100000001001     111  11  101  1
      100011111001     1 1      101 111
      100001100001     111      101  1
      100001000001              101
      11110111111111111111111111101
      10000000000000000000000000001
11111111111111111111111111111111111