Wont work if 
	Multiple declaration of the same txr/color are present
	does finish with '.xpm'
	absence of a wall txr/color declaration


NO ./textures/paper1.XPM

SO ./textures/paper2.XPM

WE ./textures/paper3.XPM

EA ./textures/paper4.XPM

C 136,169,189
F 119,186,131

111
1011
10011111111
10000000001
10001111001
1N001  1001
10000111111
100001111
1000000011111111111
1000000000000000111
1011110110000000001
 100000110000000011
  10000110111111111
  110111101
  1101  101
  110111101
 1000001101
 1001000001
 1001100001
 1100001111
 10011111
 1001
1100111111     111
1000000001     101
1111000001     111
1000000001
1000001001
1010000011
100000000111111111
111111100000000001
      100000111001
      100000001001
      100011111001
      100001100001
      100001000001
      111111111111
